$leveldim 10 10

$player 4 6 0 0
$guard 4 4 -1 0
$guard 7 2 0 -1
$guard 1 8 1 0

$tiledata
WWWWWWWWWW
W*W-^-W--W
W-W---W--W
W-WWW----W
W------WWW
W^W-W^^-^W
W------WWW
W-WWW--|-W
W--^---WeW
WWWWWWWWWW