$leveldim 40 25

$player 4 6 0 0
$guard 4 4 -1 0
$guard 7 2 0 -1
$guard 1 8 1 0

$tiledata
WWWWWWWWWWWWWWWWWWWWWWWWWWWWWWWWWWWWWWWW
W-------------------------------------eW
W--------------------------------------W
W--------------------------------------W
W--------------------------------------W
W--------------------------------------W
W--------------------------------------W
W--------------------------------------W
W--------------------------------------W
W--------------------------------------W
W--------------------------------------W
W--------------------------------------W
W--------------------------------------W
W--------------------------------------W
W--------------------------------------W
W--------------------------------------W
W--------------------------------------W
W--------------------------------------W
W--------------------------------------W
W--------------------------------------W
W--------------------------------------W
W--------------------------------------W
W--------------------------------------W
W--------------------------------------W
WWWWWWWWWWWWWWWWWWWWWWWWWWWWWWWWWWWWWWWW